00000100000
01011111110
01110001010
01110111010
00000101010
01011101010
01010100010
01110101110
00010001010
01110111010
00000100000
