00000100000
01111101110
01000100010
01110111010
00010101010
01110101110
01000001000
01011101110
01010100010
01110101110
00000100000
