00000100000
01111101110
00000100010
01110111010
01010101010
01011101110
01000000000
01011111110
01010000010
01110111110
00000100000
