00000100000
01011111110
01010000010
01111101110
00000101000
01111101110
01010000010
01011101110
01000101000
01110101110
00000100000
